0,0,0,0,0,0,0,0,0,0,0,0,0,0,0,0,0,0,0,0
0,0,0,0,0,0,0,0,0,0,0,0,0,0,0,0,0,0,0,0
0,0,0,0,0,0,0,0,0,0,0,0,0,0,0,0,0,0,0,0
0,0,0,0,0,0,0,0,0,0,0,0,0,0,0,0,0,0,0,0
0,0,0,0,0,0,0,0,0,0,0,0,0,0,0,0,0,0,0,0
0,0,0,0,0,7,8,8,8,10,2,2,2,6,8,8,9,0,0,0
0,0,0,0,0,0,0,0,0,0,1,1,1,0,0,0,0,0,0,0
7,8,8,8,9,0,0,7,8,10,1,1,1,0,0,0,0,0,0,0
0,0,0,0,0,0,0,0,0,0,0,0,0,0,0,0,0,0,0,0
0,5,5,5,0,0,0,5,0,5,5,0,0,0,4,4,4,4,0,0
2,2,2,2,2,2,2,2,2,2,2,2,4,4,3,3,3,3,4,4
1,1,1,1,1,1,1,1,1,1,1,3,1,1,3,3,3,3,3,3
1,1,1,1,1,1,1,1,1,1,1,1,1,3,3,3,3,3,3,3